{
  difficulty: 1,
  size: [5, 9],
  data: [
    [2, 0, 2, 0, 2, 0, 2, 0, 2],
    [0, 2, 0, 2, 0, 2, 4, 2, 0],
    [2, 0, 2, 0, 2, 6, 2, 0, 2],
    [0, 2, 5, 2, 0, 2, 0, 2, 0],
    [2, 0, 2, 0, 2, 0, 2, 2, 6],
  ]
}