{
  difficulty: 0,
  size: [5, 9],
  data: [
    [0, 0, 0, 0, 0, 0, 0, 0, 0],
    [0, 1, 0, 0, 0, 0, 0, 1, 5],
    [0, 0, 0, 0, 1, 0, 0, 0, 0],
    [0, 1, 4, 0, 0, 0, 0, 1, 0],
    [0, 0, 0, 0, 0, 0, 0, 0, 3],
  ]
}