{
  difficulty: 1,
  size: [5, 9],
  data: [
    [2, 3, 2, 0, 2, 0, 2, 0, 2],
    [0, 2, 0, 2, 0, 2, 0, 2, 0],
    [2, 0, 2, 0, 2, 3, 2, 0, 2],
    [0, 2, 0, 2, 0, 2, 3, 2, 0],
    [2, 0, 2, 3, 2, 0, 2, 0, 2],
  ]
}