{
  difficulty: 0,
  size: [5, 9],
  data: [
    [0, 1, 0, 3, 1, 0, 0, 0, 1],
    [0, 0, 0, 0, 0, 0, 0, 0, 0],
    [0, 0, 3, 1, 0, 3, 0, 1, 0],
    [0, 0, 0, 0, 0, 0, 0, 0, 0],
    [3, 0, 2, 2, 0, 2, 2, 3, 0],
  ]
}