{
  difficulty: 0,
  size: [5, 9],
  data: [
    [0, 0, 0, 0, 0, 0, 0, 0, 0],
    [0, 1, 0, 0, 0, 3, 0, 1, 0],
    [0, 0, 0, 0, 1, 0, 0, 0, 0],
    [0, 1, 3, 0, 0, 0, 0, 1, 0],
    [0, 0, 0, 0, 0, 0, 0, 3, 3],
  ]
}