{
  difficulty: 0,
  size: [5, 9],
  data: [
    [1, 1, 1, 1, 1, 1, 1, 1, 1],
    [0, 0, 3, 0, 0, 0, 0, 0, 0],
    [0, 0, 0, 2, 0, 2, 0, 0, 3],
    [0, 0, 2, 0, 2, 0, 2, 0, 0],
    [0, 0, 0, 0, 3, 0, 0, 0, 0],
  ]
}