[
  {
    index: 0,
    difficulty: 0,
    data: [
      [0, 0, 0, 0, 0, 0, 0, 0, 0],
      [0, 0, 0, 0, 0, 0, 0, 0, 0],
      [0, 0, 0, 0, 0, 0, 0, 0, 0],
      [0, 0, 0, 0, 0, 0, 0, 0, 0],
      [0, 0, 0, 0, 0, 0, 0, 0, 0],
    ]
  },
  {
    index: 1,
    difficulty: 0,
    data: [
      [0, 0, 0, 0, 0, 0, 0, 0, 0],
      [0, 0, 0, 0, 0, 0, 0, 0, 0],
      [0, 0, 0, 1, 1, 1, 0, 0, 0],
      [0, 0, 0, 0, 0, 0, 0, 0, 0],
      [0, 0, 0, 0, 0, 0, 0, 0, 0],
    ]
  },
  {
    index: 2,
    difficulty: 0,
    data: [
      [0, 0, 0, 0, 0, 0, 0, 0, 0],
      [0, 1, 0, 0, 0, 0, 0, 1, 0],
      [0, 0, 0, 0, 1, 0, 0, 0, 0],
      [0, 1, 0, 0, 0, 0, 0, 1, 0],
      [0, 0, 0, 0, 0, 0, 0, 0, 0],
    ]
  },
  {
    index: 3,
    difficulty: 0,
    data: [
      [1, 1, 1, 1, 1, 1, 1, 1, 1],
      [0, 0, 0, 0, 0, 0, 0, 0, 0],
      [0, 0, 0, 2, 0, 2, 0, 0, 0],
      [0, 0, 2, 0, 2, 0, 2, 0, 0],
      [0, 0, 0, 0, 0, 0, 0, 0, 0],
    ]
  },
  {
    index: 4,
    difficulty: 0,
    data: [
      [0, 0, 0, 0, 0, 0, 0, 0, 0],
      [0, 0, 0, 0, 0, 0, 0, 0, 0],
      [0, 0, 0, 0, 0, 0, 0, 0, 0],
      [0, 0, 0, 0, 0, 0, 0, 0, 0],
      [2, 1, 2, 1, 2, 1, 2, 1, 2],
    ]
  },
  {
    index: 5,
    difficulty: 1,
    data: [
      [0, 0, 0, 0, 0, 0, 0, 0, 0],
      [0, 0, 0, 0, 0, 0, 0, 0, 0],
      [0, 0, 0, 0, 0, 0, 0, 0, 0],
      [0, 0, 0, 0, 0, 0, 0, 0, 0],
      [2, 0, 2, 0, 2, 0, 2, 0, 2],
    ]
  }
]
